Title; 	 Artist


Playlist 1: 
The Immortals;	Kings of Leon
A Tout Le Monde - Remastered 2004;	Megadeth
Tie Your Mother Down - Remastered 2011;	Queen
The Way It Was;	The Killers
I Got A Car;	George Strait
Flying High Again;	Ozzy Osbourne
Imitation Of Life;	R.E.M.
IDGAF;	Dua Lipa
Summertime;	Kenny Chesney
Quiero;	Shakira
簡單愛;	Jay Chou
Cruise;	Florida Georgia Line
The Face;	Kings of Leon
Tainted Love;	Marilyn Manson
Hello;	SHINee
Louder than bombs;	BTS
Entre Caníbales - Remasterizado 2007;	Soda Stereo


Playlist 2: 
Es Épico;	Canserbero
Think;	Aretha Franklin
3:15;	Bazzi
Cry Baby;	Melanie Martinez
Should I Stay or Should I Go - Remastered;	The Clash
American Woman;	Lenny Kravitz
Mucho Corazón;	Luis Miguel
I Am a Rock;	Simon & Garfunkel
Get Down On It;	Kool & The Gang
Romeo And Juliet;	Dire Straits
Mistletoe;	Justin Bieber
Cheatham County;	Upchurch
Streatham;	Dave
Apologize;	OneRepublic
If I Were a Boy;	Beyoncé
I Shot The Sheriff;	Eric Clapton
Bleeding Love;	Leona Lewis


Playlist 3: 
Come Back;	Pearl Jam
Cigarettes & Alcohol - Remastered;	Oasis
I Hold On;	Dierks Bentley
Had Enough;	Breaking Benjamin
MONSTERS;	Shinedown
Loco por Ti;	Los Temerarios
La Libertad;	Alvaro Soler
Desesperado;	José José
Ahora Eh;	Manuel Turizo
Youngblood - Acoustic;	5 Seconds of Summer
Over My Head;	Fleetwood Mac
Stay Beautiful;	Taylor Swift
M.I.A.;	Avenged Sevenfold
Skateaway;	Dire Straits
Bicycle Race - Remastered 2011;	Queen
Hand in My Pocket;	Alanis Morissette
Mr. Moustache;	Nirvana


Playlist 4: 
Running With The Wolves;	AURORA
Lost In Yesterday;	Tame Impala
About Today;	The National
Djadja;	Aya Nakamura
Movement;	Hozier
Let Her Go;	Passenger
Beso;	CNCO
Do It Again;	Elevation Worship
Road Trippin';	Red Hot Chili Peppers
bloodline;	Ariana Grande
Angel By The Wings;	Sia
(I Can't Help) Falling In Love With You;	UB40
Fingertips;	Tom Gregory
Beautiful World;	Hikaru Utada
Movie;	Tom Misch
Sunkissed;	khai dreams
Rise Up;	TheFatRat


Playlist 5: 
El Tra;	Tito "El Bambino"
It's A Hard Life - Remastered 2011;	Queen
두근거려 (Beautiful);	BAEKHYUN
Payaso;	José José
The Way You Don't Look At Me;	Demi Lovato
Ice Cream Man;	Tyga
Eyes Shut;	Years & Years
Yo Te Quiero;	Marc Anthony
KABRIOLETY;	Taco Hemingway
Inkem Inkem Inkem Kaavaale;	Sid Sriram
I Can't Dance - Remastered 2007;	Genesis
Dear Name;	IU
Bolivienne;	Niska
Young God;	Halsey
Someone New;	Hozier
Never Grow Up;	Taylor Swift
Debra;	Beck


Playlist 6: 
Thank You For The Music;	ABBA
Are You with Me;	Lost Frequencies
Vision of Love;	Mariah Carey
Ashes - from "Deadpool 2" Motion Picture Soundtrack;	Céline Dion
Girls Like You;	Maroon 5
Dime Que No;	Ricardo Arjona
Skinny Love;	Birdy
Coprimi le spalle;	Gazzelle
Huracán;	Gera MX
Kanave Kanave;	Anirudh Ravichander
Sigo Vivo;	Joan Sebastian
Italia;	Jul
Freaking Me Out;	Ava Max
River Of Tears;	Alessia Cara
us;	keshi
Quién Me Ha Robado el Mes de Abril;	Joaquín Sabina
Keep the Car Running;	Arcade Fire


Playlist 7: 
Chunky;	Bruno Mars
Forever & Always (Taylor’s Version);	Taylor Swift
Me Enamoré;	Shakira
Bigmouth Strikes Again - 2011 Remaster;	The Smiths
Sarah Smiles;	Panic! At The Disco
Mr. Clean;	Yung Gravy
Confident;	Demi Lovato
Milkshake;	Kelis
Wonder;	Shawn Mendes
Awake;	Godsmack
911;	Lady Gaga
Lion;	Hollywood Undead
SELFISH;	The Kid LAROI
Can't Be Tamed;	Miley Cyrus
Trouble;	Cage The Elephant
High and Dry;	Radiohead
Red Lights;	Tiësto


Playlist 8: 
I;	Lil Skies
Tenemos Que Hablar;	Bad Bunny
Summer Love;	Justin Timberlake
Boys Don't Cry;	The Cure
Us;	James Bay
Paradise;	BTS
St. Tropez;	J. Cole
Love Never Felt So Good;	Michael Jackson
Coming Home;	Leon Bridges
Máquina do Tempo;	Matuê
Raisons;	SCH
Mr. Brightside;	The Killers
Boy Division;	My Chemical Romance
Cry Baby;	The Neighbourhood
Free Bird;	Lynyrd Skynyrd
Runaway (U & I);	Galantis
Si Estuviésemos Juntos;	Bad Bunny


Playlist 9: 
Toot It And Boot It;	YG
Don't Rain On My Parade (Glee Cast Version);	Glee Cast
Rock 'n' Roll (Will Take You to the Mountain);	Skrillex
Loup noir;	SCH
Don't Matter - Recorded at Spotify Studios NYC;	Lauv
Street;	Capo Plaza
All I Wanna Do;	Jay Park
GTR;	Naps
I Bet;	Ciara
Hoffnung;	Kontra K
Ace Hood Flow;	Skepta
Got 2 Luv U - feat. Alexis Jordan;	Sean Paul
Swimming Pools (Drank);	Kendrick Lamar
Wu-Tang: 7th Chamber;	Wu-Tang Clan
Uprising;	Sabaton
BODY PARTS - I denti;	Marracash
Just One Day;	BTS


Playlist 10: 
Starships;	Nicki Minaj
Cielo a un Diablo;	Maluma
SMS;	Samra
Pound The Alarm;	Nicki Minaj
Rack City;	Tyga
Freak;	Lana Del Rey
Tattooed Heart;	Ariana Grande
Okay;	Chase Atlantic
I'll Be Over You;	TOTO
Love Scars;	Trippie Redd
Wasted Years - 2015 Remaster;	Iron Maiden
True Colors;	The Weeknd
CORALINE;	Måneskin
Wake Me Up - Acoustic;	Aloe Blacc
Violent Crimes;	Kanye West
Yummy;	Justin Bieber
You & I;	One Direction


Playlist 11: 
Love so sweet;	ARASHI
Dumb Blonde;	Dolly Parton
She-Wolf - Remastered 2004 / Remixed;	Megadeth
Yo Más Te Adoro;	Morat
Ring of Fire;	Johnny Cash
El Corrido de el Fantasma - En Vivo;	Los Dos Carnales
En Menos de Un Minuto;	T3R Elemento
Too Hot;	Kool & The Gang
Sure Shot;	Beastie Boys
One Night Love Affair;	Bryan Adams
Hush;	Deep Purple
Heirate mich;	Rammstein
I Won't Back Down;	Johnny Cash
Blackout;	RIN
Ahora Es;	Wisin & Yandel
This Train Don't Stop There Anymore;	Elton John
Detalhes;	Hungria Hip Hop


Playlist 12: 
Back In Black;	AC/DC
Maze;	Juice WRLD
Far Away;	Nickelback
Faneto;	Chief Keef
Money;	Cardi B
BOOMBAYAH;	BLACKPINK
Rosanna;	TOTO
Hey Joe;	Jimi Hendrix
Live Like You Were Dying;	Tim McGraw
Easter In Miami;	Kodak Black
Up;	Cardi B
Why Does My Heart Feel so Bad?;	Moby
Last First Kiss;	One Direction
Paypal;	Teto
Stop This Train;	John Mayer
Tighten Up;	The Black Keys
Ultra;	Booba


Playlist 13: 
Addicted;	Amy Winehouse
On the Road Again;	Willie Nelson
Main Hoon Saath Tere;	Arijit Singh
Dulce Locura;	La Oreja de Van Gogh
Note to Self;	J. Cole
She Moves In Her Own Way;	The Kooks
Ilamai Thirumbudhe - From "Petta";	Anirudh Ravichander
Blue Christmas;	Elvis Presley
El Mismo Sol;	Alvaro Soler
Yo Quisiera Amarla;	Aventura
Vai Que Bebereis - Ao Vivo;	Henrique & Juliano
All Shook Up;	Elvis Presley
Slow Down;	Pamungkas
I Can;	Nas
Tus Besos;	Juan Luis Guerra 4.40
Me Dijeron;	Ozuna
La Gran Señora;	Jenni Rivera


Playlist 14: 
Lo Que No Fue No Será;	José José
Esta Cobardia;	Valentín Elizalde
Me Llamas;	Piso 21
The Weekend;	Brantley Gilbert
Springsteen;	Eric Church
Love Me Do - Remastered 2009;	The Beatles
I Can't Go for That (No Can Do);	Daryl Hall & John Oates
Si el Norte Fuera el Sur;	Ricardo Arjona
The Name Of The Game;	ABBA
Coffee & TV;	Blur
La Puerta Negra;	Los Tigres Del Norte
Por Qué No Le Calas;	Jenni Rivera
Fallin' All In You;	Shawn Mendes
Chicken Fried;	Zac Brown Band
Long Time Gone;	The Chicks
You Need Me, I Don't Need You;	Ed Sheeran
Disappear;	INXS


Playlist 15: 
Blue Jeans;	Lana Del Rey
Close Your Eyes;	Michael Bublé
Grenade - Acoustic;	Bruno Mars
Someone Somewhere (In Summertime);	Simple Minds
Psycho Killer;	Talking Heads
Angel;	NCT 127
Still The Same;	Bob Seger
Fitter Happier;	Radiohead
Skin;	Rihanna
Donde Nadie Pueda Ir;	Manuel Medrano
Till There Was You - Remastered 2009;	The Beatles
In the City - 2013 Remaster;	Eagles
If I Could Turn Back Time;	Cher
Take Care;	Beach House
Blood - Hidden Track;	My Chemical Romance
La petite voix;	PNL
Pochette;	Capo Plaza


Playlist 16: 
Anunciação / Put Your Records On - Superstar;	Melim
Marry Me;	Jason Derulo
Mi Vida Sin Ti (En Vivo);	Jesús Adrián Romero
Lookalike;	Conan Gray
Sei Un Pensiero Speciale;	Eros Ramazzotti
Romanza;	Andrea Bocelli
oneway;	Cro
Mi Segunda Vida;	La Arrolladora Banda El Limón De Rene Camacho
Last Kiss;	Taylor Swift
Nuestro amor será leyenda;	Alejandro Sanz
Nos;	ANAVITÓRIA
Déjenme Llorar;	Carla Morrison
Dependente;	Sorriso Maroto
BlackMold;	BONES
Love on the Weekend;	John Mayer
this is me trying;	Taylor Swift
MUGRE;	WOS


Playlist 17: 
Hollaback Girl;	Gwen Stefani
The Masterplan;	Oasis
Prinzessa;	Capital Bra
Tô Com Moral No Céu! - Ao Vivo;	Matheus & Kauan
This Must Be My Dream;	The 1975
Rain;	BTS
A Solas;	Maria Becerra
Californication;	Red Hot Chili Peppers
Sandman;	America
Qué Nivel De Mujer;	Luis Miguel
Perdóname;	Los Temerarios
Ain't No Mountain High Enough;	Diana Ross
Photograph;	Nickelback
Save You Tonight;	One Direction
Let Your Hair Down;	MAGIC!
After the Thrill Is Gone - 2013 Remaster;	Eagles
Zimzalabim;	Red Velvet


Playlist 18: 
Positive Vibration;	Bob Marley & The Wailers
Entre Quatro Paredes - Ao Vivo;	Marília Mendonça
Los Castigados - Remasterizado;	Bronco
Vengo dalla luna;	Måneskin
How Come You Don't Call Me;	Alicia Keys
Peg;	Steely Dan
Les matins;	Angèle
Vamo a Busal;	Jowell & Randy
Fake Tales Of San Francisco;	Arctic Monkeys
Impressionando os Anjos;	Gustavo Mioto
Family Affair - Radio Edit;	Mary J. Blige
Que Alguien Me Diga;	Gilberto Santa Rosa
Wave of Mutilation - UK Surf;	Pixies
Let Me Know;	LANY
unlasting;	LiSA
Gråzon;	Hov1
Tantita Pena;	Alejandro Fernández


Playlist 19: 
Tere Sang Yaara;	Atif Aslam
Kamikaze;	Lil Mosey
Como É Que a Gente Fica - Ao Vivo;	Henrique & Juliano
Estos Tragos Van Por Ti;	Carin Leon
Old Man;	Neil Young
Aunque Ahora Estés Con El;	Ricardo Montaner
Mi Sorpresa Fuiste Tú;	Calibre 50
Don't Speak;	No Doubt
Where Does My Heart Beat Now;	Céline Dion
The First Cut Is the Deepest;	Rod Stewart
Banana Pancakes;	Jack Johnson
Marry Me;	Jason Derulo
Quizás Si, Quizás No;	Grupo Bryndis
Je veux tes yeux;	Angèle
Hace Mucho Tiempo;	Arcangel
Teen Idle;	MARINA
I Knew You Were Trouble.;	Taylor Swift


Playlist 20: 
Never Too Late;	Three Days Grace
Be Without You - Kendu Mix;	Mary J. Blige
I Stand Alone;	Godsmack
She Looks So Perfect;	5 Seconds of Summer
Deira City Centre;	Night Lovell
Out of My League;	Fitz and The Tantrums
S&M;	Rihanna
Unforgettable;	Thomas Rhett
It's Time;	Imagine Dragons
Talkin' Tennessee;	Morgan Wallen
She's Kinda Hot;	5 Seconds of Summer
You Found Me;	The Fray
Go Your Own Way - 2004 Remaster;	Fleetwood Mac
I Feel Fine - Remastered 2015;	The Beatles
Sleeping With A Friend;	Neon Trees
Cold Cold Cold;	Cage The Elephant
Tu Vida en la Mía;	Marc Anthony


Playlist 21: 
Rumour Has It;	Adele
Who We Be;	DMX
Bella;	Mijares
Strong;	London Grammar
Seu Polícia - Ao Vivo;	Zé Neto & Cristiano
less of you;	keshi
Control;	Halsey
Yo Más Te Adoro;	Morat
Keep the Car Running;	Arcade Fire
I Won't Last A Day Without You;	Carpenters
Talk Show Host;	Radiohead
Wonderful Tonight;	Eric Clapton
You're Such A;	Hailee Steinfeld
Back To Manhattan;	Norah Jones
Media Naranja;	La Arrolladora Banda El Limón De Rene Camacho
Dulce Locura;	La Oreja de Van Gogh
Bésame;	Ricardo Montaner


Playlist 22: 
Back to You;	John Mayer
More Than This;	One Direction
Bad;	Michael Jackson
Vendetta;	Slipknot
All Summer Long;	Kid Rock
Lady Blue;	Bunbury
Sugar;	Maroon 5
Romeo+Juliet -Love goes on-;	HIRAIDAI
Formidable;	Stromae
Don't Stop (Color on the Walls);	Foster The People
Veneno;	Anitta
Zimbabwe;	Bob Marley & The Wailers
Caminando por la vida;	Melendi
Answer : Love Myself;	BTS
Run;	Bring Me The Horizon
Break the Ice;	Britney Spears
VERGOGNA;	Madame


Playlist 23: 
Yo Nací para Amarte;	Alejandro Fernández
Return to Pooh Corner;	Kenny Loggins
Una canzone che non so;	Gazzelle
Come Back;	Pearl Jam
So Will I (100 Billion X);	Hillsong Worship
That I Would Be Good - Live / Unplugged;	Alanis Morissette
Aunque no sea conmigo - 2018 Remaster;	Bunbury
My old story;	IU
Me Dice Que Me Ama;	Jesús Adrián Romero
BUMBLE BEE;	Night Lovell
Truly Madly Deeply;	One Direction
White Noise;	Rain Sounds
Tujhe Kitna Chahein Aur (Film Version);	Jubin Nautiyal
PARKINSON;	Gazo
It's Alright;	Mother Mother
Juegos De Seducción - Me Verás Volver Gira 2007;	Soda Stereo
Happy;	Leona Lewis
